9 9
1 1
3
7 3 7 4 7 5
3 3 3 3 3 4 4 4 4
3 1 0 0 3 4 4 4 4
3 0 2 2 3 4 3 3 3
3 0 2 0 3 4 3 0 3
3 3 3 0 3 3 3 0 3
4 3 3 0 0 0 0 0 3
4 3 0 0 0 3 0 0 3
4 3 0 0 0 3 3 3 3
4 3 3 3 3 3 4 4 4