6 8
1 2
5
1 5 1 6 2 6 3 6 4 6
4 3 3 3 3 4
3 3 0 0 3 4
3 1 2 0 3 4
3 3 2 0 3 3
3 3 0 2 0 3
3 0 2 0 0 3
3 0 0 2 0 3
3 3 3 3 3 3
